[FNames]
Абдула=Абдула
Абдуло=Абдул
Абдулі=Абдул
Абрам=Абрам
Аврам=Аврам
Адам=Адам
Адоль=Адольф
Алі=Алі
Альбер=Альбер
Анастас=Анастас
Анатолі=Анатолій
Андрій=Андрій
Андріян=Андріян
Анісім=Анісім
Антон=Антон
Аполон=Аполон
Апполон=Апполон
Арам=Арам
Аркад=Аркадій
Армен=Армен
Арсенов=Арсен
Арсенів=Арсен
Арсенті=Арсентій
Артамон=Артамон
Артем=Артем
Артур=Артур
Архип=Архип
Афанас=Афанас
Борис=Борис
Броніслав=Броніслав
В'ячеслав=В'ячеслав
Вагіз=Вагіз
Вадим=Вадим
Вазген=Вазген
Валентин=Валентин
Валер'ян=Валер'ян
Валері=Валерій
Вальтер=Вальтер
Васил=Василь
Веніамін=Веніамін
Віктор=Віктор
Вілен=Вілен
Вініамін=Вініамін
Віталі=Віталій
Владислав=Владислав
Володимир=Володимир
Всеволод=Всеволод
Вячеслав=Вячеслав
В'ячеслав=В'ячеслав
Гавриіл=Гавриіл
Гаврилов=Гаврило
Галі=Галій
Геннад=Геннадій
Генріх=Генріх
Георгі=Георгій
Герасим=Герасим
Герман=Герман
Гліб=Гліб
Гнат=Гнат
Горді=Гордій
Григорі=Григорій
Гурам=Гурам
Гусейн=Гусейн
Давід=Давід
Давидович=Давид
Дамір=Дамір
Даніл=Даніло
Данил=Данило
Дем'ян=Дем'ян
Дементі=Дементій
Деніс=Деніс
Денис=Денис
Дмитр=Дмитро
Едуард=Едуард
Емануїл=Емануїл
Євгено=Євген
Євгені=Євгеній
Євдоким=Євдоким
Євстаф=Євстафій
Євтихі=Євтихій
Євтух=Євтух
Єгор=Єгор
Єлисе=Єлисей
Єлісе=Єлісей
Єпіфан=Єпіфан
Єрмола=Єпіфан
Єрофі=Єрофій
Єфрем=Єфрем
Залман=Залман
Захар=Захар
Зинові=Зиновій
Зігмунд=Зігмунд
Зінад=Зінад
Зінові=Зіновій
Зорі=Зорій
Зот=Зот
Ібрагім=Ібрагім
Іван=Іван
Ігнат=Ігнат
Ігор=Ігор
Ізраіл=Ізраіль
Іларіон=Іларіон
Іліан=Іліан
Ілл=Ілля
Ільдар=Ільдар
Інокенті=Інокентій
Іраклі=Іраклій
Ісак=Ісак
Йон=Йон
Йосип=Йосип
Йосиф=Йосиф
Казимир=Казимир
Казімір=Казімір
Каміл=Каміль
Карл=Карл
Кар=Кар
Карп=Карп
Кирил=Кирило
Кіндрат=Кіндрат
Клімент=Клімент
Климент=Климент
Клім=Клім
Клим=Клим
Кондрат=Кондрат
Конон=Конон
Корнил=Корнил
Костянтин=Костянтин
Ксенофонт=Ксенофонт
Кузьм=Кузьма
Купріян=Кузьм
Лавренті=Лаврентій
Лазар=Лазар
Лєван=Лєван
Леван=Леван
Лекандр=Лекандр
Леонід=Леонід
Леон=Леон
Леонтій=Леонтій
Лєнар=Лєнар
Логвин=Логвин
Логвін=Логвін
Лонгін=Лонгін
Лук'ян=Лук'ян
Лук=Лука
Льв=Лев
Людвиг=Людвиг
Маїс=Маїс
Макар=Макар
Максим=Максим
Малах=Малах
Марк=Марк
Мартин=Мартин
Матві=Матвій
Мефоді=Мефодій
Микит=Микита
Микол=Микола
Минч=Мин
Мирон=Мирон
Мирослав=Мирослав
Митроф=Митрофан
Михайл=Михайло
Мойсіч=Мойсій
Мурад=Мурад
Мусі=Мусій
Назар=Назар
Накіп=Накіп
Наум=Наум
Нестер=Нестер
Никандр=Никандр
Никифор=Никифор
Никіфор=Никіфор
Никон=Никон
Никонор=Никонор
Нил=Нил
Ніл=Ніл
Нікон=Нікон
Нодар=Нодар
Овсі=Овсій
Олег=Олег
Олександр=Олександр
Олексі=Олексій
Омелян=Омелян
Оникі=Оникій
Онисим=Онисим
Онуфрі=Онуфрій
Опана=Опанас
Остап=Остап
Павл=Павло
Панас=Панас
Пантелеймон=Пантелеймон
Пантелі=Пантелій
Парфен=Парфен
Парфірійович=Парфірій
Парфіріївна=Парфірій
Парфірович=Парфір
Парфірівна=Парфір
Петр=Петро
Пилип=Пилип
Пимен=Пимен
Піон=Піон
Платон=Платон
Полікарп=Полікарп
Прокопі=Прокопій
Прокопович=Прокоп
Прокопівна=Прокоп
Прохор=Прохор
Радіон=Радіон
Раміс=Раміс
Рафаіл=Рафаіл
Рафаїл=Рафаїл
Рінат=Рінат
Ріфкат=Ріфкат
Роберт=Роберт
Роман=Роман
Ростіслав=Ростіслав
Руслан=Руслан
Рустам=Рустам
Сабір=Сабір
Савелі=Савелій
Савел=Савел
Сав=Сава
Салім=Салім
Самойл=Самойл
Самсон=Самсон
Самуіл=Самуіл
Самуїл=Самуїл
Саф=Сафа
Сафрон=Сафрон
Свирид=Свирид
Свиридон=Свиридон
Святослав=Святослав
Севостян=Севостян
Селиверст=Селиверст
Селіверст=Селіверст
Семен=Семен
Серафим=Серафим
Сергі=Сергій
Сидор=Сидор
Сил=Сила
Симон=Симон
Сігізмунд=Сігізмунд
Спирид=Спирид
Спиридон=Спиридон
Станіслав=Станіслав
Степан=Степан
Стефан=Стефан
Султан=Султан
Тагір=Тагір
Тадеуш=Тадеуш
Танасі=Танасій
Тарас=Тарас
Теренті=Терентій
Тимофі=Тимофій
Тит=Тит
Тихон=Тихон
Тігран=Тігран
Трохим=Трохим
Тух=Тух
Ульян=Ульян
Улян=Улян
Устим=Устим
Устин=Устин
Фаде=Фадей
Фаді=Фадій
Фарит=Фарит
Фатохул=Фатохул
Федор=Федір
Федір=Федір
Федосі=Федосій
Федос=Федос
Федот=Федот
Феодосі=Феодосій
Филимон=Филимон
Філімон=Філімон
Флегонт=Флегонт
Фоат=Фоат
Фом=Фома
Франц=Франц
Фрідріх=Фрідріх
Фрол=Фрол
Хайдар=Хайдар
Хайм=Хайм
Хаім=Хаім
Хамед=Хамед
Ханалі=Ханалій
Харитон=Харитон
Харламп=Харламп
Хасан=Хасан
Хасбі=Хасбій
Хом=Хома
Хрисанф=Хрисанф
Христофор=Христофор
Хустул=Хустул
Шаріф=Шаріф
Юзеф=Шаріф
Юліан=Юліан
Юлі=Юлій
Юрі=Юрій
Юстин=Юстин
Юхим=Юхим
Яким=Яким
Яков=Яков
Якуб=Якуб
Янович=Ян
Яношевич=Янош
Ярослав=Ярослав
